mild_winter = { 383 636 67 384 68 73 403 385 38 39 51 640 48 405 404 389 72 386
387 396 395 639 47 474 55 228 227 476 226 225 224 223 222 221 229 220 512 231 219
233 234 235 236 241 211 212 217 213 215 218 216 214 207 206 205 204 208 842 115 117 118
839 114 841 840 116 113 835 108 95 96 94 823 103 92 93 109 108 833 834 90 91
280 818 815 812 272 273 275 792 277 274 811 576 618 575 621 577 607 624 617 616
615 614 613 608 611 612 613 614 615 577 578 583 622 601 602 600 584 585 586
554 544 543 553 552 551 545 542 63 59 65 546 56 475 69 890 888 887 991
886 891 892 893 894 793 756 791 817 232 237 203 836 434 429 428 427
419 418 417 416 341 644 355 356 357 358 928 929 930 931 932 941 933 934
582 638 46 634 635 230
}
normal_winter = {
796 795 794 716 715 992 276 797 605 604 603 597 596 595 597 623 599 589
588 587 541 540 539 538 548 549 547 547 598 537 536 619 534 533 528 527
529 525 524 521 526 521 520 519 518 517 516 515 514 513 509 510 507 505 504 503
502 501 500 499 498 497 493 494 490 495 999 492 491 642 57 487 488 486
484 54 482 483 481 641 53 485 480 479 52 478 477 414 415 410 407 806 409 411
412 413 810 807 402 401 809 808 391 390 388 392 74 889 278 393
438 394 654 653 436 437 349 348 346 345 344 645 342 646 343 420 423 421 425
424 422 47 431 432 433 435 406 496 610 609 408 647 506 508 511
}
severe_winter = {
593 592 594 591 590 538 535 532 523 530 522 489 895 896 897 898 899
998 657 656 655 652 651 430 648 649 650 426 421 531
}